441444144401111111111114-
141414141111111111111114-
141414141121111111111111-
141414141131111111111111-
141414141141111111111111-
141414141151111111111111-
144414441144111111111111-
144414441144111111111111-
144414441144111111111111-
111111111111111111111111	